111111
1P0C11
100001
1C0E11
111111
